111111111111111111111111
100000000000000000000001
10000000000P00000000001D
100000000000000000000001
10000000000000000000001D
100000000000000000000001
10000000000P00000000001D
100000000000000000000001
10000000000000000000001D
100000000000000000000001
10000000000P00000000001D
100000000000000000000001
10000000000000000000001D
111111111111111111111111
