111111111111111111111111
10000000M000001000000001
100000M0000S0MD0000M000D
11111111111D111111111111
1000000000000M0000000001
111111111111111111111111
