1111111111111111111111
1000000000100000000001
1000000000100000000001
1000000000100000000001
1000000000000000000001
1000000000100000000001
1000000000100000000001
1000000000100000000001
1000000000100000000001
111111D11111111111101111
100010000000100000000001
100000000000100000000001
1R0010000000100000000001
111110000000100000000001
10000001D10000100000000001
1000000G0000100000000001
100000000000100000000001
1000000N0000100000000001
111111111111111111111111