111111111111111111111111
100000000000001000000001
10000000000S0MD0000M000D
11111111111D111111111111
1000000000000M0000000001
111111111111111111111111
