1111111111111111111111
1000000000100000000001
1000000000100000000001
1000000000100000000001
1000000000000000000001
1000000000100000000001
1000000000100000000001
1000000000100000000001
1000000000100000000001
111111L11111111111101111
100010000000100000000001
100000000000100000000001
1G0010000000100000000001
11O110000000100000000001
100000000000100000000001
100000000000100000000001
100000000000100000000001
1000000N0000100000000001
111111111111111111111111