111111111111111111111111
100000000000001000000001
10000000000S00D00000000D
10000000000000100000M001
100000000000000000000001
111111111111111111111111

