1111111111111P1111111111
100000000000000000000001
10000000000S00000000000P
100000000000000000000001
111111111111111111111111

