111111111111111111111111
100000000000001000000001
10000000000S00D0000000MD
11111111111D111111111111
100000000000000000000001
111111111111111111111111
